5 1 1 1 1 1 1 1 1 1 1 1 1 1 1 6 9 9 9 9 9 9 5 1 1 1 1 1 1 1 1 1 1 1 1 1 1 6 9 9 9 9 9 9 5 1 1 1 1 1 1 1 1 1 1 1 6 9 9 9 9 9 9 9 9 9 9 9 9 9 9 9 9 9 9 9 9 9 9 9 9 9
2 0 0 0 0 0 0 0 0 0 0 0 0 0 0 3 9 9 9 9 9 9 2 0 0 0 0 0 0 0 0 0 0 0 0 0 0 3 9 9 9 9 9 9 2 0 0 0 0 0 16 0 0 0 0 0 3 9 9 9 9 9 9 9 9 9 9 9 9 9 9 9 9 9 9 9 9 9 9 9 9 9
2 0 0 0 0 0 0 0 0 0 0 0 0 0 0 3 9 9 9 9 9 9 2 0 0 0 0 0 0 0 0 0 0 0 0 0 0 3 9 9 9 9 9 9 2 0 0 16 0 0 16 0 0 16 0 0 3 9 9 9 9 9 9 9 9 9 5 1 1 1 1 1 1 1 1 1 1 1 1 1 1 6
2 0 0 0 0 0 0 0 0 0 0 0 0 0 0 3 9 9 9 9 9 9 2 0 0 0 0 0 0 0 0 0 0 0 0 0 0 3 9 9 9 9 9 9 2 0 0 16 0 0 16 0 0 16 0 0 3 9 9 9 9 9 9 9 9 9 2 0 0 0 0 0 0 0 0 0 0 0 0 0 0 3
2 0 0 0 0 0 0 0 0 0 0 0 0 0 0 12 1 1 1 1 1 1 13 0 0 0 0 0 0 0 0 0 0 0 0 0 0 3 9 9 9 9 9 9 2 0 0 16 0 0 16 0 0 16 0 0 12 1 1 1 1 1 1 1 1 1 13 0 0 0 0 0 0 0 0 4 4 4 4 4 4 11
2 0 0 0 0 0 0 0 0 0 0 0 0 0 0 0 0 0 0 0 0 0 0 0 0 0 0 0 0 0 0 0 0 0 0 0 0 3 9 9 9 9 9 9 2 0 0 16 0 0 16 0 0 16 0 0 0 0 0 0 0 0 0 0 0 0 0 0 0 0 0 0 0 0 0 0 9 9 9 9 9 9
2 0 0 0 0 0 0 0 0 0 0 0 0 0 0 0 0 0 0 0 0 0 0 0 0 0 0 0 0 0 0 0 0 0 0 0 0 3 9 9 9 9 9 9 2 0 0 16 0 0 0 0 0 16 0 0 0 0 0 0 0 0 0 0 0 0 0 0 0 0 0 0 0 0 0 1 1 1 1 1 1 6
2 0 0 0 0 0 0 0 0 0 0 0 0 0 0 14 4 4 4 4 4 4 15 0 0 0 0 0 0 0 0 0 0 0 0 0 0 3 9 9 9 9 9 9 2 0 0 19 17 17 17 17 17 17 17 14 4 4 4 4 4 4 4 4 4 4 15 0 0 0 0 0 0 0 0 0 0 0 0 0 0 3
2 0 0 0 0 0 0 0 0 0 0 0 0 0 0 3 9 9 9 9 9 9 10 4 4 4 4 4 15 17 17 17 17 17 17 0 0 3 9 9 9 9 9 9 2 0 0 0 0 0 0 0 0 0 0 3 9 9 9 9 9 9 9 9 9 9 10 4 4 4 4 4 4 4 4 4 4 4 4 4 4 11
2 0 0 0 0 0 0 0 0 0 0 0 0 0 0 3 9 9 9 9 9 9 9 9 9 9 9 9 2 0 0 0 0 0 0 0 0 3 9 9 9 9 9 9 10 4 4 4 4 4 15 0 0 0 0 3 9 9 9 9 9 9 9 9 9 9 9 9 9 9 9 9 9 9 9 9 9 9 9 9 9 9
2 0 0 0 0 0 0 0 0 0 0 0 0 0 0 3 9 9 9 9 9 9 9 9 9 9 9 9 2 0 0 0 0 0 0 0 0 3 9 9 9 9 9 9 9 9 9 9 9 9 2 0 0 0 0 3 9 9 9 9 9 9 9 9 9 9 9 9 9 9 9 9 9 9 9 9 9 9 9 9 9 9
10 4 4 4 4 4 4 4 4 4 4 4 4 4 4 11 9 9 9 9 9 9 9 9 9 9 9 9 2 0 0 14 4 4 4 4 4 11 9 9 9 9 9 9 9 9 9 9 9 9 2 0 0 14 4 11 9 9 9 9 9 9 9 9 9 9 9 9 9 9 9 9 9 9 9 9 9 9 9 9 9 9
9 9 9 9 9 9 9 9 9 9 9 9 9 9 9 9 9 9 9 9 9 9 9 9 9 9 9 9 2 0 0 3 9 9 9 9 9 9 9 9 9 9 9 9 9 9 9 9 9 9 2 0 0 3 9 9 9 9 9 9 9 9 9 9 9 9 9 9 9 9 9 9 9 9 9 9 9 9 9 9 9 9
9 9 9 9 9 9 9 9 9 9 9 9 9 9 9 9 9 9 9 9 9 9 9 9 9 9 9 9 2 0 0 3 9 9 9 9 9 9 9 9 9 9 9 9 9 9 9 9 9 9 2 0 0 3 9 9 9 9 9 9 9 9 9 9 9 9 9 9 9 9 9 9 9 9 9 9 9 9 9 9 9 9
9 9 9 9 9 9 9 9 9 9 9 9 9 9 9 9 9 9 9 9 9 9 9 9 9 9 9 9 2 0 0 3 9 9 9 9 9 9 9 9 9 9 9 9 9 9 9 9 9 9 2 0 0 3 9 9 9 9 9 9 9 9 9 9 9 9 9 9 9 9 9 9 9 9 9 9 9 9 9 9 9 9
9 9 9 9 9 9 9 9 9 9 9 9 9 9 9 9 9 9 9 9 9 9 9 9 9 9 9 9 2 0 0 3 9 9 9 9 9 9 9 9 9 9 9 9 9 9 9 9 9 9 2 0 0 3 9 9 9 9 9 9 9 9 9 9 9 9 9 9 9 9 9 9 9 9 9 9 9 9 9 9 9 9
9 9 9 9 9 9 9 9 9 9 9 9 9 9 9 9 9 9 9 9 9 9 9 9 9 9 9 9 2 0 0 3 9 9 9 9 9 9 9 9 9 9 9 9 9 9 9 9 9 9 2 0 0 3 9 9 9 9 9 9 9 9 9 9 9 9 9 9 9 9 9 9 9 9 9 9 9 9 9 9 9 9
9 9 9 9 9 9 9 9 9 9 9 9 9 9 9 9 9 9 9 9 9 9 9 9 9 9 9 9 2 0 0 3 9 9 9 9 9 9 9 9 9 9 9 9 9 9 9 9 9 9 2 0 0 3 9 9 9 9 9 9 9 9 9 9 9 9 9 9 9 9 9 9 9 9 9 9 9 9 9 9 9 9
9 9 9 9 9 9 9 9 9 9 9 9 9 9 9 9 9 9 9 9 9 9 9 9 9 9 9 9 2 0 0 3 9 9 9 9 9 9 9 9 9 9 9 9 9 9 9 9 9 9 2 0 0 12 1 1 1 1 1 6 9 9 9 9 9 9 9 9 9 9 9 9 9 9 9 9 9 9 9 9 9 9
9 9 9 9 9 9 9 9 9 9 9 9 9 9 9 9 9 9 9 9 9 9 9 9 9 9 9 9 2 0 0 3 9 9 9 9 9 9 9 9 9 9 9 9 9 9 9 9 9 9 2 0 0 0 0 0 0 0 0 3 9 9 9 9 9 9 9 9 9 9 9 9 9 9 9 9 9 9 9 9 9 9
9 9 9 9 9 9 9 9 9 9 9 9 9 9 9 9 9 9 9 9 9 9 9 9 9 9 9 9 2 0 0 3 9 9 9 9 9 9 9 9 9 9 9 9 9 9 9 9 9 9 2 0 0 0 0 0 0 0 0 3 9 9 9 9 9 9 9 9 9 9 9 9 9 9 9 9 9 9 9 9 9 9
9 9 9 9 9 9 9 9 9 9 9 9 9 9 9 9 9 9 9 9 9 9 5 1 1 1 1 1 13 0 0 12 1 1 1 1 1 6 9 9 9 9 9 9 5 1 1 1 1 1 13 0 0 0 0 0 16 0 0 3 9 9 9 9 9 9 9 9 9 9 9 9 9 9 9 9 9 9 9 9 9 9
9 9 9 9 9 9 9 9 9 9 9 9 9 9 9 9 9 9 9 9 9 9 2 0 0 0 0 0 0 0 0 0 0 0 0 0 0 12 1 1 1 1 1 1 13 0 0 0 0 0 16 0 0 0 0 0 16 0 0 3 9 9 9 9 9 9 9 9 9 9 9 9 9 9 9 9 9 9 9 9 9 9
9 9 9 9 9 9 9 9 9 9 9 9 9 9 9 9 9 9 9 9 9 9 10 4 15 0 21 20 0 21 20 0 21 20 0 0 0 0 0 0 0 0 0 0 0 0 0 0 0 0 16 0 0 0 0 0 16 0 0 3 9 9 9 9 9 9 9 9 9 9 9 9 9 9 9 9 9 9 9 9 9 9
9 9 9 9 9 9 9 9 9 9 9 9 9 9 9 9 9 9 9 9 9 9 5 1 13 0 19 18 0 19 18 0 19 18 0 0 0 0 0 0 0 0 0 0 0 0 0 0 0 0 16 0 0 0 0 0 16 0 0 3 9 9 9 9 9 9 9 9 9 9 9 9 9 9 9 9 9 9 9 9 9 9
9 9 9 9 9 9 9 9 9 9 9 9 9 9 9 9 9 9 9 9 9 9 2 0 0 0 0 0 0 0 0 0 0 0 0 0 0 14 4 4 4 4 4 4 4 4 4 15 0 0 16 0 0 0 0 0 16 0 0 3 9 9 9 9 9 9 9 9 9 9 9 9 9 9 9 9 9 9 9 9 9 9
9 9 9 9 9 9 9 9 9 9 9 9 9 9 9 9 9 9 9 9 9 9 10 4 4 4 4 4 15 0 0 14 4 4 4 4 4 11 9 9 9 9 9 9 9 9 9 2 0 0 19 17 17 17 17 17 18 0 0 3 9 9 9 9 9 9 9 9 9 9 9 9 9 9 9 9 9 9 9 9 9 9
9 9 9 9 9 9 9 9 9 9 9 9 9 9 9 9 9 9 9 9 9 9 9 9 9 9 9 9 10 4 4 11 9 9 9 9 9 9 9 9 9 9 9 9 9 9 9 2 0 0 0 0 0 0 0 0 0 0 0 3 9 9 9 9 9 9 9 9 9 9 9 9 9 9 9 9 9 9 9 9 9 9
9 9 9 9 9 9 9 9 9 9 9 9 9 9 9 9 9 9 9 9 9 9 9 9 9 9 9 9 9 9 9 9 9 9 9 9 9 9 9 9 9 9 9 9 9 9 9 2 0 0 0 0 0 0 0 0 0 0 0 3 9 9 9 9 9 9 9 9 9 9 9 9 9 9 9 9 9 9 9 9 9 9
9 9 9 9 9 9 9 9 9 9 9 9 9 9 9 9 9 9 9 9 9 9 9 9 9 9 9 9 9 9 9 9 9 9 9 9 9 9 9 9 9 9 9 9 9 9 9 10 4 4 4 4 4 4 4 4 4 4 4 11 9 9 9 9 9 9 9 9 9 9 9 9 9 9 9 9 9 9 9 9 9 9